NO 					./maps/n.xpm
SO 			./maps/s.xpm
WE 			./maps/w.xpm
EA			./maps/e.xpm
F 128,128,128
C 135,206,235







        1111111111111111111111111
        1000000000110000000000001
        1011000001110000000000001
        1001000000000000000000001
111111111011000001110000000000001
100000000011000001110111111111111
11110111111111011100000010001
11110111111111011101010010001
11000000110101011100000010001
10000000000000000000000000001
10000000000000001101010010101
11000001110101011111111110N0111
11110111 1110101 10000000001
11111111 1111111 111111111111