NO 			./maps/xpm/e_wall_texture.xpm
SO 			./maps/xpm/n_wall_texture.xpm
WE 			./maps/xpm/s_wall_texture.xpm
EA			./maps/xpm/w_wall_texture.xpm
F     220,100,0
C 225,30,0

11111111
100000S1
11111001
10000001
10110001
10010111
10010001
11111111