NO ./maps/xpm/lab_north.xpm
SO ./maps/xpm/lab_south.xpm
WE ./maps/xpm/lab_west.xpm

EA ./maps/xpm/lab_east.xpm


F 44,52,64
C 160,196,224

111111111111111111111111
1N0000001000000000000001
101111010101111111011101
100001010100000001010001
111101011111011101010111
100001000001010001010001
101111111101010111011101
101000000001010100000101
101011111111010101110101
101010000000010100010101
101010111111110111010101
101010100000000001010101
101000101111111101000101
101110100000000101111101
100000000111000000000001
111111111111111111111111
