NO 			./maps/xpm/n_wall_texture.xpm
SO 			./maps/xpm/s_wall_texture.xpm
WE 			./maps/xpm/w_wall_texture.xpm
EA			./maps/xpm/e_wall_texture.xpm
F     220,100,0
C 112,90,52

111111111111111111111111111111111111111111111111111111111111111111111111111111111111111111111111111111111111111111111111111111111111111111
100000000000000000000000000000000000000000000000000000000000000000000000000000000000000000000000000000000000000000000000000000000000000001
1E0100000000000000000000000000000000000000000000000000000000000000000000000000000000000000000000000000000000000000000000000000000000000001
100000000000000000000000000000000000000000000000000000000000000000000000000000000000000000000000000000000000000000000000000000000000000001
111111111111111111111111111111111111111111111111111111111111111111111111111111111111111111111111111111111111111111111111111111111111111111
